30
40
WWWWWWWWWWWWWWWWWWWWWWWWWWWWWW
W                            W
W                            W
W                            W
W                            W
W                            W
W                            W
W                            W
W                            W
W                            W
W                            W
W                            W
W                            W
W                            W
W                            W
W                            W
W                            W
W                            W
W                            W
W                            W
W                            W
W                            W
W                            W
W                            W
W                            W
W                            W
W            WWWW            W
W            WWWW            W
W            WWWW            W
W            WWWW            W
W                            W
W                            W
WWWWWWWWWWWWW    WWWWWWWWWWWWW
W                            W
W                            W
W                            W
W                            W
W                            W
W                            W
WWWWWWWWWWWWWWWWWWWWWWWWWWWWWW