30
30
WWWWWWWWWWWWWWWWWWWWWWWWWWWWWW
W                            W
W                            W
W                            W
W                            W
W                            W
W                            W
W                            W
W                            W
W                            W
W                            W
W                            W
W                            W
W                            W
W                            W
W                            W
W                            W
W                            W
W                            W
W                            W
W                            W
W                            W
W                            W
WWWWWWWWWWWWW    WWWWWWWWWWWWW
W                            W
W                            W
W                            W
W                            W
W                            W
WWWWWWWWWWWWWWWWWWWWWWWWWWWWWW