10
50
WWWWWWWWWW
W        W
W        W
W        W
W        W
W        W
W        W
W        W
W        W
W        W
W        W
W        W
W        W
W        W
W        W
W        W
W        W
W        W
W        W
W        W
W        W
W        W
W        W
W        W
W        W
W        W
W        W
W        W
W        W
W        W
W        W
W        W
W        W
W        W
W        W
W        W
W        W
W        W
W        W
W        W
WWW    WWW
W        W
W        W
W        W
W        W
W        W
W        W
W        W
W        W
WWWWWWWWWW